Chinese	Pinyin	English	Status
阿米巴病	āmǐbābìng	Amoebiasis	Learnt
阿司匹林	āsīpǐlín	aspirin	Incorrect
癌变	áibiàn	cancerous	Learnt
癌症	áizhèng	cancer	Incorrect
艾滋病	àizībìng	AIDS	Incorrect
嗳气	àiqì	belching	Incorrect
安慰	ānwèi	comfort	
按摩	ànmó	massage	Learnt
熬夜	áoyè	stay up	Incorrect
B型超声	B xíng chāoshēng	B-mode ultrasound	Incorrect
疤	bā	scar	Incorrect
拔牙术	báyá shù	tooth extraction	Learnt
白斑	báibān	Leukoplakia	Learnt
白癜风	báidiànfēng	Vitiligo	Learnt
白喉	báihóu	diphtheria	Learnt
白化病	báihuàbìng	Albinism	Incorrect
白沫	báimò	white foam	Incorrect
白内障	báinèizhàng	cataract	Incorrect
白细胞	báixìbāo	leukocyte	Learnt
白血病	báixuèbìng	leukemia	Incorrect
白质	báizhì	white matter	Learnt
百日咳	bǎirìké	pertussis	Learnt
败血症	bàixuèzhèng	septicemia	Learnt
班	bān	class	Incorrect
板状腹	bǎnzhuàng fù	plate belly	
办理	bànlǐ	handle	
半衰期	bànshuāiqī	half life	Learnt
半月板	bànyuèbǎn	meniscus	Incorrect
伴随	bànsuí	to accompany	Learnt
伴有	bànyǒu	accompanied by	Incorrect
包括	bāokuò	include	
包扎	bāozā	to bandage	Learnt
薄	bó	Thin	Incorrect
保持	bǎochí	Maintain	Learnt
保健	bǎojiàn	health care	Learnt
保守	bǎoshǒu	keep	Learnt
保险	bǎoxiǎn	Insurance	Learnt
保养	bǎoyǎng	maintainance	
报告	bàogào	Report	Incorrect
暴饮暴食	bàoyǐnbàoshí	overeating	Learnt
悲观	bēiguān	pessimistic	Learnt
北部	běibù	the north	Learnt
奔马律	bēnmǎ lǜ	galloping law	Learnt
绷带	bēngdài	bandage (noun)	Learnt
鼻旁窦	bípángdòu	paranasal sinuses	Learnt
鼻涕	bítì	snot	Learnt
鼻咽癌	bíyānái	nasopharyngeal carcinoma	Incorrect
比例	bǐlì	Proportion	
必要	bìyào	necessary	Learnt
闭经	bìjīng	amenorrhea	Incorrect
避免	bìmiǎn	avoid	Learnt
避孕	bìyùn	contraception	
臂	bì	arm	Learnt
边界	biānjiè	boundary	
边缘	biānyuán	edge	
扁平苔癣	biǎnpíng táixuǎn	Lichen planus	
扁桃体炎	biǎntáotǐyán	tonsillitis	
变态反应	biàntàifǎnyìng	allergy	
变应原	biànyìngyuán	allergen	Incorrect
变质	biànzhì	Deteriorate 	Incorrect
便秘	biànmì	constipate	Incorrect
便血	biànxiě	blood in stool	Incorrect
遍布	biànbù	all over	Learnt
标本	biāoběn	specimen	
标记	biāojì	mark	
表面	biǎomiàn	surface	Learnt
表现	biǎoxiàn	Performance	
憋	biē	hold back	
并发症	bìngfāzhèng	complication	Incorrect
病案室	bìngàn shì	Medical record room	Incorrect
病程	bìngchéng	course of disease	Learnt
病毒	bìngdú	Virus	Learnt
病理	bìnglǐ	pathology	Learnt
病历	bìnglì	medical records	
病例	bìnglì	cases	
病史	bìngshǐ	medical history	Learnt
病危/重	bìngwēi / zhòng	Critically ill/serious	Incorrect
病因	bìngyīn	Etiology	Learnt
病原	bìngyuán	pathogen	Learnt
脖子	bózi	neck	
不孕	bùyùn	infertility	
补充	bǔchōng	Replenish	Learnt
补救	bǔjiù	remedy	Learnt
补体	bǔtǐ	complement	Learnt
补液	bǔyè	rehydration	
哺乳	bǔrǔ	breast-feeding	Learnt
不良	bùliáng	bad	Learnt
不详	bùxiáng	unknown	Incorrect
不足	bùzú	insufficient	
步骤	bùzhòu	step	Learnt
部位	bùwèi	parts	
采集	cǎijí	collection	
采取	cǎiqǔ	take	
采血室	cǎixuè shì	blood collection room	
彩超	cǎichāo	Color Doppler	
参考	cānkǎo	refer to	
参与	cānyù	participate	
残疾	cánjí	disabled	Incorrect
残留	cánliú	residual	Learnt
残胃癌	cán wèiái	Stomach cancer	Incorrect
苍白	cāngbái	pale	Learnt
操作	cāozuò	operate	
侧面	cèmiàn	side	Learnt
侧脑室	cènǎoshì	lateral ventricle	
侧支循环	cèzhī xúnhuán	collateral circulation	
测量	cèliáng	Measurement	
插	chā	insert	Incorrect
查房	cháfáng	rounds	
拆	chāi	dismantle	Learnt
产程	chǎnchéng	labor process	Incorrect
产道	chǎndào	Birth canal	Learnt
产后出血	chǎnhòu chūxuè	postpartum hemorrhage	
产力	chǎnlì	Productivity	Learnt
产褥期	chǎnrùqī	puerperium	
产生	chǎnshēng	produce	
颤抖	chàndǒu	trembling	Incorrect
肠闭锁	cháng bìsuǒ	intestinal atresia	Learnt
肠鸣音	cháng míngyīn	Bowel sounds	Incorrect
肠套叠	chángtàodié	intussusception	Incorrect
肠系膜	chángxìmó	Mesentery	Incorrect
场所	chǎngsuǒ	place	Incorrect
超敏反应	chāomǐnfǎnyìng	hypersensitivity reaction	
潮湿	cháoshī	wet	
彻底	chèdǐ	thorough	
沉默	chénmò	silence	Incorrect
辰僵	chén jiāng	Morning stiffness	Learnt
成分	chéngfèn	Element	Incorrect
成人	chéngrén	Adult	Learnt
成熟	chéngshú	Mature	Learnt
承受	chéngshòu	Endure	
程度	chéngdù	degree	Incorrect
吃力	chīlì	strenuous	
迟缓	chíhuǎn	slow	
持续	chíxù	continued	
尺骨	chǐgǔ	ulna	Incorrect
耻骨联合	chǐgǔ liánhé	pubic symphysis	Learnt
冲服	chōngfú	blunt	Learnt
充分	chōngfèn	full	Learnt
虫蛀牙	chóng  zhùyá	Tooth Decay	Incorrect
宠物	chǒngwù	parasite	Incorrect
抽搐	chōuchù	twitch	Incorrect
臭	chòu	Smelly	Learnt
初步	chūbù	Preliminary	Learnt
初产妇	chūchǎnfù	Primipara	
初乳	chūrǔ	colostrum	Learnt
处方	chǔfāng	prescription	Learnt
处理	chǔlǐ	deal with	
处女膜	chǔnǚmó	hymen	
杵状指	chǔ zhuàngzhǐ	Clubbing	
触诊	chùzhěn	palpation	Learnt
穿刺术	chuāncìshù	puncture	Learnt
穿孔	chuānkǒng	perforation	Incorrect
传播	chuánbō	spread	Learnt
传导阻滞	chuándǎo zǔzhì	conduction block	
传染	chuánrǎn	infect	
喘气	chuǎnqì	pant	Learnt
喘息	chuǎnxī	gasp/pant	Learnt
创伤	chuāngshāng	trauma	Learnt
垂体	chuítǐ	pituitary	Incorrect
雌激素	cíjīsù	Estrogen	
刺桐	cìtóng	Erythrina	Incorrect
刺激	cìjī	Stimulate	Incorrect
粗糙	cūcāo	rough	Incorrect
卒中	zú zhōng	stroke	Learnt
促进	cùjìn	Promote	
猝死	cùsǐ	sudden death	Incorrect
催乳素	cuīrǔsù	prolactin	Learnt
挫裂伤	cuòlièshāng	contusion	Learnt
措施	cuòshī	measure	Incorrect
搭配	dāpèi	match	
达到	dádào	achieve	Learnt
打嗝	dǎgé	hiccup	
打喷嚏	dǎpēntì	sneeze	Incorrect
大便	dàbiàn	Feces	Incorrect
大肠杆菌	dàchánggǎnjūn	Escherichia coli	
代替	dàitì	replace	
丹毒	dāndú	erysipelas	
单纯	dānchún	simple	
单核细胞	dānhéxìbāo	monocytes	
单位	dānwèi	unit	Learnt
耽误	dānwu	hold up	Learnt
胆道蛔虫	dǎndào huíchóng	Biliary Ascaris	Learnt
胆固醇	dǎngùchún	cholesterol	
胆红素	dǎnhóngsù	Bilirubin	Learnt
胆囊	dǎnnáng	gallbladder	
胆石病	dǎnshíbìng	gallstone disease	Learnt
胆汁	dǎnzhī	bile	Incorrect
胆汁酸	dǎnzhīsuān	bile acid	Incorrect
胆总管	dǎnzǒngguǎn	common bile duct	
蛋白质	dànbáizhì	protein	Learnt
氮质血症	dànzhì xuèzhèng	Azotemia	
导尿术	dǎoniào shù	Catheterization	
导泻	dǎoxiè	catharsis	Learnt
导致	dǎozhì	lead to	
登记	dēngjì	to register	
等候	děnghòu	waiting	Incorrect
低钠血症	dīnàxuèzhèng	Hyponatremia	Learnt
低氧血症	dīyǎng xuèzhèng	Hypoxemia	Learnt
滴	dī	drop	
骶骨	dǐgǔ	sacrum	
蒂	dì	pedicle	Incorrect
癫痫	diānxián	epilepsy	Learnt
典型	diǎnxíng	typical	Learnt
碘剂	diǎnjì	iodine	Learnt
电除颤	diàn chúchàn	defibrillation	Learnt
电复律	diànfù lǜ	Cardioversion	Incorrect
点击	diǎnjī	click	Learnt
电解质	diànjiězhì	electrolyte	Learnt
淀粉酶	diànfěnméi	Amylase	Learnt
耵聍	dīngníng	Cerumen	Incorrect
顶叶	dǐngyè	parietal lobe	Incorrect
定期	dìngqī	regular	
动脉	dòngmài	artery	
动物模型	dòngwùmóxíng	animal model	Learnt
动眼神经	dòngyǎnshénjīng	oculomotor nerve	
动作电位	dòngzuòdiànwèi	Action potential	Learnt
冻僵	dòngjiāng	frozen	Learnt
冻伤	dòngshāng	frostbite	Incorrect
窦房结	dòufángjié	sinus node	Incorrect
堵塞	dǔsè	block	
端坐呼吸	duānzuò hūxī	orthopnea	
断端	duànduān	stump	Incorrect
堆积	duījī	accumulation	Learnt
对症治疗	duìzhèng zhìliáo	Symptomatic treatment	Learnt
多胞胎	duōbāotāi	multiple births	Incorrect
多发性	duōfāxìng	multiple	Learnt
鹅口疮	ékǒuchuāng	thrush	Learnt
额叶	éyè	frontal lobe	Incorrect
恶心	èxīn	nausea	Learnt
恶化	èhuà	deterioration	Incorrect
恶露	èlù	lochia	
儿茶酚胺	rcháfēnàn	Catecholamines	Incorrect
耳聋	ěrlóng	deaf	Learnt
耳鸣	ěrmíng	tinnitus	Incorrect
耳蜗	ěrwō	cochlea	Incorrect
发病机制	fābìng jīzhì	pathogenesis	Learnt
发抖	fādǒu	trembling	Learnt
发绀	fāgàn	Cyanosis	Incorrect
发热	fārè	fever	Learnt
发炎	fāyán	inflamed	Learnt
发育	fāyù	development	Incorrect
发作	fāzuò	attack	Learnt
发力	fālì	work hard	
烦躁不安	fánzàobùān	anxious	
繁殖	fánzhí	reproduce	
反常	fǎncháng	abnormal	
反而	fǎnér	instead	Learnt
反复	fǎnfù	repeatedly	Learnt
反射	fǎnshè	reflection	
反酸	fǎnsuān	acid reflux	Learnt
反跳痛	fǎntiàotòng	rebound pain	
反应	fǎnyìng	reaction	Incorrect
范围	fànwéi	range	Learnt
方案	fāngàn	plan	Learnt
门诊	ménzhěn	clinic	Incorrect
防御	fángyù	defense	Incorrect
防止	fángzhǐ	prevent	Incorrect
防治	fángzhì	prevention	Incorrect
房间隔	fángjiāngé	interatrial septum	Learnt
房室结	fángshì jié	atrioventricular node	Incorrect
放大	fàngdà	enlarge	Learnt
放射	fàngshè	radiation	
腓骨	féigǔ	fibula	
肺不张	fèibùzhāng	atelectasis	Learnt
肺大泡	fèidàpào	Bullae	Incorrect
肺动脉瓣	fèidòngmàibàn	pulmonary valve	Incorrect
肺活量	fèihuóliàng	vital capacity	Learnt
肺门	fèimén	hilum	
肺气肿	fèiqìzhǒng	Emphysema	
肺纹理	fèi wénlǐ	lung markings	Learnt
肺性脑病	fèixìng nǎobìng	pulmonary encephalopathy	Incorrect
费用	fèiyòng	cost	Learnt
分布	fēnbù	distributed	
分化	fēnhuà	differentiation	Incorrect
分裂	fēnliè	Split	Learnt
分泌	fēnmì	secretion	Learnt
分娩	fēnmiǎn	childbirth	
分析	fēnxī	analyze	Learnt
分型	fēnxíng	classification	
粉末	fěnmò	powder	Incorrect
风湿病	fēngshībìng	rheumatism	Learnt
风湿热	fēngshīrè	rheumatic fever	Incorrect
风险	fēngxiǎn	risk	Learnt
缝合术	fènghé shù	Suture	
敷	fū	apply	Learnt
浮肿	fúzhǒng	edema	Learnt
幅度	fúdù	amplitude	Learnt
辐射	fúshè	radiation	
辅助	fǔzhù	auxiliary	Incorrect
附件	fùjiàn	appendix	Incorrect
复查	fùchá	review	Learnt
复发	fùfā	relapse	Learnt
复位	fùwèi	reset	
复诊	fùzhěn	Follow-up visit	Incorrect
副神经	fùshénjīng	accessory nerve	Learnt
副作用	fùzuòyòng	side effect	Learnt
腹部	fùbù	abdomen	Learnt
腹肌紧张	fùjī jǐnzhāng	tight abdominal muscles	Learnt
腹腔	fùqiāng	abdominal cavity	
腹泻	fùxiè	diarrhea	Learnt
腹痛	fùtòng	stomach ache	Learnt
改善	gǎishàn	improve	Learnt
钙	gài	calcium	Learnt
甘油三酯	gānyóusānzhǐ	Triglycerides	
肝	gān	liver	Incorrect
肝病面容	gānbìng miànróng	liver disease face	
肝门静脉	gān ménjìngmài	hepatic portal vein	Incorrect
肝素	gānsù	heparin	
肝性脑病	gānxìng nǎobìng	hepatic encephalopathy	Incorrect
肝硬化	gānyìnghuà	liver cirrhosis	Learnt
肝掌	gānzhǎng	liver palm	
赶紧	gǎnjǐn	quickly	
感觉器官	gǎnjuéqìguān	sensory organs	Incorrect
感染	gǎnrǎn	Infect	
感染源	gǎnrǎn yuán	Source of infection	Learnt
干咳	gānké	dry cough	
干扰素	gānrǎosù	interferon	Incorrect
感眼	gǎnyǎn	eyesight	
干预	gānyù	intervene	
干燥	gānzào	dry	Learnt
干活儿	gànhuór	work	Learnt
肛管	gāngguǎn	anal canal	Learnt
肛裂	gāngliè	anal fissure	Incorrect
肛瘘	gānglòu	anal fistula	Incorrect
肛门	gāngmén	anus	Learnt
高钙血症	gāogàixuèzhèng	Hypercalcemia	
高钾血症	gāojiǎxuèzhèng	hyperkalemia	Learnt
高原病	gāoyuánbìng	altitude sickness	Learnt
睾酮	gāotóng	Testosterone	Incorrect
睾丸	gāowán	Testis	Learnt
疙瘩	gēda	Pimple	Incorrect
隔离	gélí	isolation	Learnt
膈	gé	diaphragm	Incorrect
个别	gèbié	individual	Incorrect
个人史	gèrén shǐ	personal history	Incorrect
个体	gètǐ	individual	
根除	gēnchú	eradicate	
根治	gēnzhì	cure	Learnt
跟腱断裂	gēnjiàn duànliè	Achilles tendon rupture	Incorrect
梗阻	gěngzǔ	obstruction	Incorrect
功能	gōngnéng	Function	Incorrect
肱二头肌	gōng èrtóujī	Biceps	Learnt
巩固	gǒnggù	consolidate	Learnt
肱三头肌	gōng sāntóu jī	Triceps	Learnt
肱骨	gōnggǔ	Humerus	Learnt
宫颈举痛	gōngjǐng jǔtòng	Cervical pain	Incorrect
宫颈糜烂	gōngjǐng mílàn	cervical erosion	Incorrect
宫腔镜	gōngqiāngjìng	Hysteroscopy	Learnt
宫缩	gōngsuō	contractions	Incorrect
巩膜	gǒngmó	sclera	Learnt
佝偻病	gōulóubìng	Rickets	Learnt
沟通	gōutōng	communicate	Learnt
构成	gòuchéng	constitute	Incorrect
股骨	gǔgǔ	femur	
骨擦音	gǔ cāyīn	fricative	
股四头肌	gǔ sìtóu jī	quadriceps	Learnt
骨关节炎	gǔguānjiéyán	Osteoarthritis	Incorrect
骨痂	gǔjiā	callus	Learnt
骨龄	gǔlíng	bone age	Incorrect
骨膜	gǔmó	periosteum	
骨盆	gǔpén	pelvis	Learnt
骨髓	gǔsuǐ	marrow	Incorrect
骨髓象	gǔsuǐ xiàng	bone marrow	Learnt
骨折	gǔzhé	fracture	Learnt
鼓膜	gǔmó	eardrum	Learnt
鼓室	gǔshì	tympanum	Learnt
固定	gùdìng	fixed	
顾虑	gùlǜ	concern	Incorrect
挂号	guàhào	registered	Learnt
拐杖	guǎizhàng	crutch	Learnt
关节	guānjié	joint	Learnt
关节镜	guānjiéjìng	Arthroscopy	Learnt
关节面	guānjié miàn	articular surface	Learnt
关节囊	guānjié náng	Joint capsule	Learnt
关节腔	guānjié qiāng	Joint cavity	Learnt
观察	guānchá	observe	Learnt
冠心病	guānxīnbìng	coronary heart disease	Learnt
管型	guǎnxíng	cast	Incorrect
光滑	guānghuá	smooth	
广泛	guǎngfàn	widely	Learnt
规律	guīlǜ	law	Learnt
过度	guòdù	over	Incorrect
过度乳	guòdù rǔ	excessive milk	Learnt
过敏	guòmǐn	allergy	
过期产儿	guòqī chǎnér	Overdue baby	Learnt
过期妊娠	guòqī rènshēn	overdue pregnancy	
海鲜	hǎixiān	seafood	
含服	hánfù	Take it	
含量	hánliàng	content	
寒战	hánzhàn	chills	
罕见	hǎnjiàn	rare	Incorrect
好转	hǎozhuǎn	get better	Incorrect
合理	hélǐ	Reasonable	Incorrect
荷尔蒙	héěrméng	hormone	Incorrect
核磁共振	hécígòngzhèn	nuclear magnetic resonance	Learnt
黑粪	hēifèn	black dung	
黑色素瘤	hēisèsùliú	melanoma	
恒牙	héngyá	permanent teeth	Learnt
虹膜	hóngmó	iris	
喉部	hóubù	throat	
后代	hòudài	offspring	Incorrect
后果	hòuguǒ	as a result of	Incorrect
后囟	hòu xìn	Posterior fontanel	Learnt
后遗症	hòuyízhèng	Sequelae	Learnt
候诊区	hòuzhěn qū	Waiting Area	Learnt
呼吸	hūxī	breathe	
呼吸链	hūxī liàn	respiratory chain	
忽略	hūlüè	neglect	Learnt
忽视	hūshì	ignore	Incorrect
护理	hùlǐ	care	Learnt
滑车神经	huáchēshénjīng	trochlear nerve	Learnt
化痰止咳	huàtánzhǐké	Reducing phlegm and relieving cough	
化验	huàyàn	assay	
怀孕	huáiyùn	Pregnant	Learnt
踝关节	huáiguānjié	ankle joint	Learnt
踝阵挛	huái zhènluán	ankle clonus	Learnt
环形红斑	huánxíng hóngbān	erythema annulare	
缓解	huǎnjiě	ease	Learnt
患者	huànzhě	patient	Learnt
黄斑	huángbān	macula	Learnt
黄疸	huángdǎn	jaundice	Incorrect
黄体	huángtǐ	corpus luteum	
灰质	huīzhì	gray matter	Learnt
恢复	huīfù	recover	
回肠	huícháng	ileum	
回归热	huíguīrè	relapsing fever	
回盲部	huímángbù	ileocecal	
回声	huíshēng	echo	
会阴	huìyīn	perineum	
会诊	huìzhěn	consultation	
昏迷	hūnmí	coma	Incorrect
荤	hūn	Meat	Learnt
婚育史	hūnyù shǐ	Marriage history	Incorrect
浑身	húnshēn	full body	Learnt
活检	huójiǎn	biopsy	
霍乱	huòluàn	cholera	Learnt
饥饿	jīè	hunger	
肌电图	jīdiàntú	EMG	
肌强直	jī qiángzhí	Muscle rigidity	
肌肉	jīròu	muscle	Incorrect
肌张力	jī zhānglì	Muscle tension	
积水	jīshuǐ	stagnant water	Learnt
基因	jīyīn	Gene	Incorrect
畸形	jīxíng	deformity	Learnt
稽留热	jīliúrè	continuous fever	
激动药	jīdòng yào	Agonists	Learnt
激素	jīsù	hormone	
及早	jízǎo	early	
急促	jícù	rapid	Incorrect
急腹症	jífùzhèng	acute abdomen	Learnt
急剧	jíjù	sharp	Incorrect
急诊	jízhěn	Emergency	Incorrect
急症手术	jízhèng shǒushù	emergency surgery	Learnt
疾病	jíbìng	disease	Incorrect
集中	jízhōng	concentrated	
籍贯	jíguàn	native place	
脊髓	jǐsuǐ	spinal cord	
脊柱侧凸	jǐzhù cètū	Scoliosis	Learnt
记录	jìlù	Record	Incorrect
记忆力	jìyìlì	memory	Learnt
既往史	jìwǎng shǐ	Past history	Learnt
继发性	jìfāxìng	Secondary	
寄生虫	jìshēngchóng	parasite	Incorrect
加剧	jiājù	exacerbated	
家属	jiāshǔ	family members	
家庭	jiātíng	family	
家族史	jiāzúshǐ	family history	Incorrect
甲沟炎	jiǎgōuyán	Paronychia	Learnt
甲亢危象	jiǎkàng wēixiàng	hyperthyroid crisis	Learnt
甲胎蛋白	jiǎtāidànbái	alpha-fetoprotein	Learnt
甲状旁腺	jiǎzhuàngpángxiàn	parathyroid gland	Incorrect
尖锐湿疣	jiānruìshīyóu	Genital warts	Incorrect
间脑	jiānnǎo	diencephalon	Incorrect
肩膀	jiānbǎng	Shoulder	Learnt
肩胛骨	jiānjiǎgǔ	shoulder blade	
监测	jiāncè	monitor	Learnt
监护	jiānhù	guardianship	Learnt
检查	jiǎnchá	examine	
检验	jiǎnyàn	test	
间隔	jiàngé	interval	
间歇	jiànxiē	Intermittent	Learnt
健全	jiànquán	sound	Learnt
腱鞘	jiànqiào	tendon sheath	Incorrect
鉴别	jiànbié	identify	Learnt
鉴定	jiàndìng	identification	
僵硬	jiāngyìng	stiff	
交叉配血	jiāochā pèixuè	cross match	Learnt
胶原	jiāoyuán	collagen	Learnt
焦虑	jiāolǜ	anxiety	Learnt
角膜	jiǎomó	cornea	Incorrect
绞痛	jiǎotòng	colic	
绞窄性	jiǎozhǎixìng	strangulation	Incorrect
矫正	jiǎozhèng	to correct	Incorrect
脚趾	jiǎozhǐ	toe	Incorrect
阶段	jiēduàn	stage	Learnt
疖	jiē	furuncle	
接触	jiēchù	touch	Learnt
接种	jiēzhòng	inoculation	Incorrect
节奏	jiézòu	Rhythm	Learnt
拮抗药	jiékàng yào	Antagonist	Learnt
结肠	jiécháng	colon	Incorrect
结缔组织	jiédìzǔzhī	connective tissue	
结合	jiéhé	combine	Learnt
结核病	jiéhébìng	Tuberculosis	
结节	jiéjié	nodules	Incorrect
结膜	jiémó	conjunctiva	Incorrect
结石	jiéshí	stone	
结扎	jiézā	ligation	
截瘫	jiétān	paraplegia	
解痉	jiě jìng	antispasmodic	
解剖	jiěpōu	anatomy	
介入	jièrù	intervention	
戒	jiè	quit	Learnt
筋膜	jīnmó	Fascia	Learnt
紧急	jǐnjí	urgent	Learnt
谨慎	jǐnshèn	cautious	
尽快	jìnkuài	ASAP	Learnt
尽量	jìnliàng	try to	
进展期	jìnzhǎn qī	advanced stage	Learnt
近亲	jìnqīn	next of kin	Incorrect
近视	jìnshì	Shortsighted	Incorrect
浸润	jìnrùn	infiltration	
禁忌症	jìnjìzhèng	Contraindications	Learnt
禁食	jìnshí	fasting	
经产妇	jīngchǎnfù	multipartum	
惊厥	jīngjué	convulsion	Learnt
晶状体	jīngzhuàngtǐ	lens	
精神	jīngshén	Spirit	
精准医学	jīngzhǔn yīxué	precision medicine	Incorrect
精子	jīngzǐ	sperm	Incorrect
精子获能	jīngzǐ huò néng	sperm capacitation	Incorrect
颈部	jǐngbù	neck	Learnt
颈椎	jǐngzhuī	cervical spine	Learnt
胫骨	jìnggǔ	tibia	
痉挛	jìngluán	spasms	Learnt
静脉	jìngmài	vein	
静脉曲张	jìngmàiqūzhāng	Varicose veins	Incorrect
静息电位	jìngxī diànwèi	resting potential	
纠正	jiūzhèng	correct	Incorrect
酒精	jiǔjīng	Alcohol	Learnt
救护车	jiùhùchē	ambulance	Learnt
就诊	jiùzhěn	see a doctor	Learnt
局部麻醉	júbù mázuì	Local anesthesia	Learnt
咀嚼	jǔjué	chew	Incorrect
巨大	jùdà	huge	Learnt
巨结肠	jù jiécháng	megacolon	Learnt
巨人症	jùrénzhèng	gigantism	Learnt
剧烈	jùliè	severe	Incorrect
绝经	juéjīng	menopause	Incorrect
绝育术	juéyù shù	Sterilization	
菌血症	jūnxuèzhèng	Bacteremia	
咯血	gēxuè	Hemoptysis	Incorrect
开瓣音	kāibànyīn	opening sound	Learnt
康复	kāngfù	recover	
抗核抗体	kànghé kàngtǐ	antinuclear antibody	Learnt
抗凝	kàngníng	anticoagulation	Learnt
抗生素	kàngshēngsù	antibiotic	Learnt
抗体	kàngtǐ	Antibody	Incorrect
抗抑郁	kàngyìyù	antidepressant	Incorrect
抗原	kàngyuán	antigen	
颗	kē	grain	
咳痰	kétán	expectoration	Incorrect
可见	kějiàn	visible	Incorrect
克罗恩病	kèluóēn bìng	Crohn's disease	Learnt
控场	kòngchǎng	field control	Learnt
空洞	kōngdòng	hollow	Incorrect
空腹	kōngfù	fasting	Learnt
恐惧	kǒngjù	fear	Incorrect
控制	kòngzhì	control	Learnt
口臭	kǒuchòu	bad breath	Incorrect
口腔	kǒuqiāng	mouth	Learnt
叩击	kòujī	tap	Incorrect
叩诊	kòuzhěn	percussion	
髋骨	kuāngǔ	hip bone	Incorrect
髋臼	kuānjiù	Acetabular	Learnt
狂犬病	kuángquǎnbìng	Rabies	Incorrect
扩散	kuòsàn	diffusion	Incorrect
扩张	kuòzhāng	expansion	Incorrect
阑尾	lánwěi	appendix	Learnt
劳累	láolèi	overworked	Learnt
老视	lǎoshì	Presbyopia	Incorrect
乐观	lèguān	optimism	Learnt
雷诺现象	léinuò xiànxiàng	Raynaud's phenomenon	Learnt
肋	lèi	rib	Incorrect
泪器	lèiqì	lacrimal apparatus	Learnt
类似	lèisì	similar	
类型	lèixíng	type	
离子通道	lízitōngdào	ion channel	
理疗	lǐliáo	physiotherapy	
利尿	lìniào	diuretic	Learnt
粒细胞	lìxìbāo	Granulocytes	Learnt
痢疾	lìji	dysentery	
连续	liánxù	continuous	Learnt
联合	liánhé	joint	
良好	liánghǎo	good	Incorrect
临产	línchǎn	in labor	Learnt
临床	línchuáng	clinical	Learnt
临终关怀	línzhōngguānhuái	hospice care	Incorrect
淋巴结	línbājié	lymph nodes	Incorrect
淋巴细胞	línbāxìbāo	Lymphocytes	Incorrect
淋病	lìnbìng	gonorrhea	Incorrect
流感	liúgǎn	influenza	Learnt
流行性	liúxíngxìng	popularity	Incorrect
流泪	liúlèi	tears	Learnt
流质	liúzhì	liquid	
聋哑	lóngyǎ	deaf mute	
露出液	lùchū yè	exposed liquid	Learnt
颅骨	lúgǔ	skull	Incorrect
颅内压	lúnèi yā	intracranial pressure	Incorrect
挛缩	luánsuō	Contracture	Learnt
卵巢	luǎncháo	ovaries	
卵泡	luǎnpào	follicle	
卵子	luǎnzi	egg	Learnt
轮状病毒	lúnzhuàngbìngdú	Rotavirus	Incorrect
落音	luòyīn	falling tone	Learnt
绿色瘤	lǜsè liú	green tumor	
麻痹	mábì	paralysis	Learnt
麻木	mámù	numbness	
麻疹	mázhěn	measles	Incorrect
麻醉	mázuì	anaesthetization	Learnt
马尾	mǎwěi	horse tail	Learnt
麦氏点	màishìdiǎn	Max point	
脉搏	màibó	pulse	Learnt
脉压	màiyā	pulse pressure	
盲肠	mángcháng	cecum	Incorrect
梅毒	méidú	syphilis	Learnt
没劲	méijìn	exhausted	Learnt
酶	méi	enzyme	Incorrect
迷路	mílù	get lost	Learnt
迷走神经	mízǒushénjīng	vagus nerve	
泌尿神经	mìniào shénjīng	urinary nerve	Learnt
泌尿系统	mìniàoxìtǒng	urinary system	Learnt
密切	mìqiè	close	Learnt
免疫	miǎnyì	immunity	
免疫调节	miǎnyìdiàojié	Immunomodulatory	Incorrect
面积	miànjī	area	Learnt
面容	miànróng	face	Incorrect
面神经	miànshénjīng	facial nerve	Learnt
灭菌	mièjūn	sterilization	Learnt
敏感	mǐngǎn	sensitive	
明确	míngquè	clear	Incorrect
明显	míngxiǎn	obvious	Learnt
摸	mō	touch	Learnt
模糊	móhu	Vague	Learnt
膜性肾病	móxìng shènbìng	membranous nephropathy	Incorrect
摩擦音	mócāyīn	fricative	Learnt
马刺月经	mǎcì yuèjīng	Spurs menstruation	
母乳	mǔrǔ	breast milk	
目光	mùguāng	look	Learnt
耐药性	nàiyàoxìng	drug resistance	Learnt
难产	nánchǎn	Dystocia	Learnt
囊性病变	náng xìngbìngbiàn	cystic lesion	Learnt
囊肿	nángzhǒng	cyst	
脑电图	nǎodiàntú	EEG	Incorrect
脑干	nǎogàn	brainstem	
脑脊液	nǎojǐyè	Cerebrospinal fluid	
脑膜瘤	nǎomóliú	Meningioma	
脑桥	nǎoqiáo	pons	Incorrect
脑疝	nǎo shàn	brain herniation	Learnt
脑死亡	nǎosǐwáng	brain death	
脑震荡	nǎozhèndàng	concussion	
内部	nèibù	internal	Incorrect
内毒素	nèidúsù	endotoxin	
内耳	nèiěr	inner ear	Learnt
内环境	nèi huánjìng	Internal environment	
内镜	nèijìng	Endoscopy	Incorrect
内囊	nèináng	Internal capsule	
内脏	nèizàng	internal organs	Learnt
逆转录酶	nìzhuǎnlùméi	reverse transcriptase	Learnt
年纪	niánjì	age	Learnt
黏膜	niánmó	mucous membrane	Incorrect
尿崩症	niàobēngzhèng	diabetes insipidus	Incorrect
尿蛋白	niàodànbái	urine protein	Learnt
尿道	niàodào	urethra	
尿毒症	niàodúzhèng	Uremia	Learnt
尿急	niàojí	urinary urgency	Learnt
尿量	niàoliàng	urine output	Incorrect
尿路感染	niàolùgǎnrǎn	urinary tract infection	Learnt
尿路梗阻	niàolù gěngzǔ	urinary tract obstruction	Learnt
尿频	niàopín	frequent urination	Incorrect
尿失禁	niàoshījìn	urinary incontinence	Learnt
尿石症	niàoshízhèng	Urolithiasis	Incorrect
尿酸	niàosuān	uric acid	Learnt
尿糖	niàotáng	urine sugar	Incorrect
尿液	niàoyè	urine fluid	Incorrect
尿潴留	niàozhūliú	urinary retention	Incorrect
颞叶	nièyè	Temporal lobe	
凝血酶	níngxuèméi	thrombin	
凝血因子	níngxuèyīnzi	clotting factor	Learnt
扭伤	niǔshāng	sprain	Incorrect
扭转	niǔzhuǎn	reverse	Incorrect
浓	nóng	concentrated	Incorrect
浓度	nóngdù	concentration	Learnt
脓毒症	nóngdúzhèng	sepsis	Learnt
脓尿	nóngniào	Pyuria	Learnt
浓痰	nóngtán	thick phlegm	Learnt
脓胸	nóngxiōng	Empyema	Incorrect
脓血便	nóngxuè biàn	bloody stool	Incorrect
疟疾	nüèjí	malaria	Incorrect
呕吐	ǒutù	Vomit	Learnt
呕血	ǒuxuè	vomiting blood	Incorrect
趴	pā	lie	Learnt
拍	pāi	shoot	Learnt
排便	páibiàn	to defecate	Learnt
排斥	páichì	repel	Incorrect
排除	páichú	exclude	
排卵	páiluǎn	ovulation	
排尿	páiniào	urination	
排气	páiqì	exhaust	Learnt
膀胱	pángguāng	bladder	Incorrect
疱疹	pàozhěn	herpes	Learnt
胚胎	pēitāi	embryo	Incorrect
培养	péiyǎng	nourish	
配合	pèihé	Cooperate	Learnt
配偶	pèiǒu	spouse	Incorrect
盆会阴部	pén huìyīnbù	Perineum	Learnt
皮肌炎	píjīyán	dermatomyositis	Learnt
皮下结节	píxià jiéjié	Subcutaneous nodules	Learnt
皮炎	píyán	dermatitis	Learnt
皮疹	pízhěn	rash	
皮质	pízhì	leather	Incorrect
疲劳	píláo	fatigue	Learnt
脾	pí	spleen	Learnt
偏	piān	Partial	Learnt
偏盲	piānmáng	Hemianopia	Learnt
偏袒	piāntǎn	favoritism	Learnt
胼胝体	piánzhī tǐ	Corpus callosum	Learnt
片	piàn	piece	Learnt
频繁	pínfán	frequently	Learnt
平常	píngcháng	usually	Learnt
平衡	pínghéng	balance	Incorrect
平滑肌	pínghuájī	smooth muscle	
平片	píngpiàn	plain film	Learnt
破伤风	pòshāngfēng	tetanus	Learnt
剖宫产	pōugōngchǎn	caesarean section	Incorrect
葡萄球菌	pútáoqiújūn	staphylococcus	Learnt
葡萄胎	pútaotāi	hydatidiform mole	
期前收缩	qīqián shōusuō	premature contraction	Learnt
奇脉	qímài	pulsus paradoxus	
期待	qīdài	expect	
起搏器	qǐbóqì	pacemaker	
气管	qìguǎn	trachea	
起色	qǐsè	improvement	Incorrect
其栓	qíshuān	bolt	Incorrect
气味	qìwèi	odor	Incorrect
气性坏疽	qìxìng huàijū	Gas gangrene	Incorrect
气胸	qìxiōng	pneumothorax	Learnt
器官	qìguān	organ	
憩室	qìshì	diverticulum	
髂骨	qiàgǔ	ilium	Learnt
牵涉痛	qiānshètòng	referred pain	
牵引	qiānyǐn	traction	
前列腺	qiánlièxiàn	prostate	Incorrect
前囟	qián xìn	bregma	Incorrect
前置	qiánzhì	Front	Learnt
潜伏	qiánfú	lurking	Learnt
钱	qián	money	Learnt
嵌顿	qiàndùn	Incarcerated	
强度	qiángdù	strength	
强烈	qiángliè	strong	Learnt
抢救	qiǎngjiù	rescue	Learnt
切除	qiēchú	resection	Learnt
切开	qiēkāi	cut open	
青春期	qīngchūnqī	puberty	
青光眼	qīngguāngyǎn	glaucoma	Learnt
青霉素	qīngméisù	penicillin	Learnt
青紫	qīngzǐ	bruising	Learnt
清除	qīngchú	to clear	
清创	qīngchuàng	debridement	Learnt
清单	qīngdān	list	Learnt
清蛋白	qīng dànbái	Albumin	Learnt
清宫	qīnggōng	Dilatation and curettage	Incorrect
清醒	qīngxǐng	wide awake	Learnt
清音	qīngyīn	Voiceless	
情绪	qíngxù	mood	
请示	qǐngshì	ask for instructions	
丘脑	qiūnǎo	thalamus	
球蛋白	qiúdànbái	globulin	
区域	qūyù	area	
屈光不正	qūguāng buzhèng	Refractive error	
龋齿	qǔchǐ	dental caries	Incorrect
全面	quánmiàn	comprehensive	Incorrect
全身	quánshēn	whole body	Learnt
全血黏度	quánxuè niándù	whole blood viscosity	
醛固酮	quángùtóng	Aldosterone	Learnt
劝	quàn	advise	
缺乏	quēfá	lack	
缺损	quēsǔn	defect	
缺陷	quēxiàn	defect	
缺氧	quēyǎng	hypoxia	Learnt
确定	quèdìng	Sure	Incorrect
确诊	quèzhěn	Diagnosed	Learnt
桡骨	ráogǔ	Radius	
热量	rèliàng	heat	Learnt
热性	rèxìng	Hot	
人工	réngōng	artificial	Incorrect
忍受	rěnshòu	to bear	Incorrect
认知	rènzhī	cognition	Incorrect
韧带	rèndài	ligament	Learnt
妊娠	rènshēn	pregnancy	Incorrect
日常	rìcháng	daily	
日期	rìqī	date	
容积	róngjī	volume	
溶栓	róngshuān	Thrombolysis	Incorrect
溶血病	róngxuè bìng	hemolytic disease	Learnt
蠕动波	rúdòng bō	peristaltic wave	Learnt
乳房	rǔfáng	breast	Learnt
乳腺炎	rǔxiànyán	mastitis	Incorrect
乳牙	rǔyá	deciduous teeth	
褥疮	rùchuāng	bedsore	
软	ruǎn	soft	
软骨瘤	ruǎngǔ liú	Chondroma	Incorrect
软化	ruǎnhuà	soften	Learnt
软组织	ruǎnzǔzhī	Soft tissue	Learnt
弱	ruò	weak	Learnt
弱视	ruòshì	amblyopia	Incorrect
腮腺炎	sāixiànyán	mumps	Incorrect
三叉神经	sānchāshénjīng	Trigeminal nerve	Incorrect
三合诊	sānhé zhěn	Triad diagnosis	Learnt
三夹瓣	sānjiābàn	Triple clip	Learnt
散光	sànguāng	astigmatism	Learnt
嗓子	sǎngzi	voice	Learnt
丧失	sàngshī	lost	
瘙痒	sàoyǎng	itching	
纱布	shābù	gauze	
筛选	shāixuǎn	filter	Learnt
晒	shài	show	Learnt
疝	shàn	hernia	Incorrect
伤害	shānghài	harm	Learnt
上颌骨	shànghégǔ	maxilla	
上皮组织	shàngpízǔzhī	epithelial tissue	
上腔静脉	shàngqiāng jìngmài	superior vena cava	Learnt
上瘾	shàngyǐn	addicted	Learnt
上肢	shàngzhī	upper body	Learnt
烧伤	shāoshāng	burn	Incorrect
舌下神经	shéxiàshénjīng	hypoglossal nerve	
舌咽神经	shéyānshénjīng	glossopharyngeal nerve	Incorrect
摄氏度	shèshìdù	Celsius	Incorrect
伸	shēn	stretch	Incorrect
身高	shēngāo	height	Learnt
呻吟	shēnyín	moan	
神经	shénjīng	nerve	Learnt
肾	shèn	kidney	Incorrect
肾单位	shèn dānwèi	nephron	Learnt
肾上腺	shènshàngxiàn	adrenal gland	Learnt
肾糖阈	shèntáng yù	renal glucose threshold	Incorrect
肾盂肾炎	shènyúshènyán	pyelonephritis	
升	shēng	Lift	
升高	shēnggāo	raised	
生理	shēnglǐ	physiological	
生命体征	shēngmìng tǐzhēng	vital signs	
生物转化	shēngwùzhuǎnhuà	Biotransformation	
生育	shēngyù	give birth	Learnt
生长	shēngzhǎng	to grow	Learnt
生长因子	shēngchángyīnzi	growth factor	Learnt
生殖系统	shēngzhíxìtǒng	reproductive system	
尸体	shītǐ	corpse	Learnt
失常	shīcháng	out of order	
失眠	shīmián	Insomnia	Learnt
失去	shīqù	lose	Incorrect
失神	shīshén	absent minded	Incorrect
失误	shīwù	mistake	
湿润	shīrùn	wet	Learnt
湿疹	shīzhěn	eczema	
十二指肠	shíèrzhǐcháng	duodenum	
石膏	shígāo	plaster	Learnt
实习	shíxí	practice	
食管	shíguǎn	esophagus	Incorrect
食物	shíwù	food	Incorrect
食欲不振	shíyùbùzhèn	loss of appetite	Learnt
示范	shìfàn	demonstration	Learnt
事故	shìgù	accident	
试验	shìyàn	test	Learnt
视力	shìlì	vision	
视网膜	shìwǎngmó	retina	
视诊	shìzhěn	inspection	Incorrect
适当	shìdàng	appropriate	Learnt
适应症	shìyìngzhèng	Indications	Learnt
室间隔	shìjiāngé	Interventricular septum	Learnt
嗜睡	shìshuì	drowsiness	Learnt
收缩	shōusuō	shrink	Incorrect
手续	shǒuxù	formalities	Learnt
手指	shǒuzhǐ	finger	Learnt
手足口病	shǒuzú kǒubìng	hand, foot and mouth disease	Learnt
收官消除	shōuguān xiāochú	Elimination	Incorrect
寿命	shòumìng	life	Incorrect
受伤	shòushāng	Injuried	
受体	shòutǐ	receptor	
授精	shòujīng	insemination	Incorrect
舒适	shūshì	comfortable	Learnt
疏忽	shūhū	negligence	
输精管	shūjīngguǎn	vas deferens	Learnt
输卵管	shūluǎnguǎn	oviduct	Learnt
输尿管	shūniàoguǎn	ureter	Learnt
输血	shūxuè	blood transfusion	Incorrect
输液室	shūyè shì	Infusion Room	Incorrect
蔬菜	shūcài	vegetable	
属于	shǔyú	belong	
数据	shùjù	data	Incorrect
数值	shùzhí	value	Incorrect
衰老	shuāilǎo	senescence	Learnt
衰弱	shuāiruò	weak	Learnt
摔倒	shuāidǎo	fall	Incorrect
双顶径	shuāngdǐng jìng	biparietal diameter	Learnt
水冲脉	shuǐ chōngmài	water pulse	Incorrect
水痘	shuǐdòu	chicken pox	Learnt
水中毒	shuǐzhōngdú	water intoxication	Incorrect
睡眠	shuìmián	to sleep	Learnt
顺畅	shùnchàng	smoothly	Incorrect
嘶哑	sīyǎ	hoarse	
死骨	sǐgǔ	bone necrosis	Incorrect
死亡	sǐwáng	die	Learnt
四肢	sìzhī	limbs	Incorrect
松弛	sōngchí	relaxation	Incorrect
苏醒	sūxǐng	wake	Incorrect
宿主	sùzhǔ	Host	Learnt
素食	sùshí	vegetarian diet	Learnt
酸碱平衡	suānjiǎn pínghéng	pH balance	Incorrect
酸痛	suāntòng	sore	Learnt
随时	suíshí	at any time	Learnt
随意	suíyì	random	Incorrect
髓质	suǐzhì	medulla	Learnt
碎尸	suìshī	corpse	
损伤	sǔnshāng	damage	
缩短	suōduǎn	shorten	
缩宫素	suōgōngsù	Oxytocin	
锁骨	suǒgǔ	clavicle	Learnt
胎产式	tāichǎnshì	fetal birth	Learnt
胎动	tāidòng	fetal movement	
胎儿	tāiér	fetus	Learnt
胎儿窘迫	tāiér jiǒngpò	fetal distress	
胎膜早破	tāimó zǎopò	premature rupture of membranes	Learnt
胎盘早博	tāipán zǎobó	premature placenta	Learnt
胎盘植入	tāipán zhírù	placenta accreta	Incorrect
胎盘滞留	tāipán zhìliú	retained placenta	Incorrect
胎位	tāiwèi	fetal position	Incorrect
太极拳	tàijíquán	Tai Chi	Incorrect
瘫痪	tānhuàn	paralysis	Learnt
炭疽	tànjū	anthrax	Incorrect
探头	tàntóu	probe	Learnt
探望	tànwàng	visit	
糖尿病	tángniàobìng	diabetes	Learnt
烫	tàng	hot	Incorrect
特殊	tèshū	special	
特征	tèzhēng	feature	
疼痛	téngtòng	pain	Learnt
体格	tǐgé	physique	Incorrect
体积	tǐjī	volume	Learnt
体外循环	tǐwàixúnhuán	Extracorporeal circulation	
体型	tǐxíng	size	Learnt
体液	tǐyè	body fluid	
体征	tǐzhēng	signs	Incorrect
体重	tǐzhòng	weight	Learnt
调整	tiáozhěng	Adjustment	Learnt
听力	tīnglì	hearing	
听诊	tīngzhěn	auscultation	Learnt
听诊器	tīngzhěnqì	stethoscope	
通体	tōngtǐ	Whole body	Incorrect
瞳孔	tóngkǒng	pupil	Learnt
痛风	tòngfēng	gout	Incorrect
痛经	tòngjīng	Dysmenorrhea	Learnt
痛苦	tòngkǔ	pain	
头部	tóubù	head	Learnt
头围	tóuwéi	head circumference	Learnt
透析	tòuxī	Dialysis	Learnt
突触	tūchù	synapse	
突发性聋	tūfāxìng lóng	sudden deafness	Incorrect
途径	tújìng	way	Learnt
涂片	túpiàn	smear	Incorrect
推测	tuīcè	guess	Learnt
退烧	tuìshāo	reduce fever	Learnt
退休	tuìxiū	retire	
吞咽	tūnyàn	to swallow	Incorrect
臀部	túnbù	buttocks	Learnt
臀大肌	túndàjī	gluteus maximus	Learnt
拖延	tuōyán	procrastination	Learnt
脱垂	tuōchuí	prolapse	Incorrect
脱离	tuōlí	break away	Learnt
脱位	tuōwèi	dislocation	
蛙腹	wāfù	frog belly	
歪	wāi	crooked	Learnt
外表	wàibiǎo	appearance	Learnt
外耳道	wàiěrdào	external auditory canal	Learnt
外翻	wàifān	eversion	Learnt
外生殖器	wàishēngzhíqì	external genitalia	
外展神经	wàizhǎnshénjīng	abducens nerve	
顽固	wángù	stubborn	
挽救	wǎnjiù	save	Incorrect
晚期	wǎnqī	Late period	
腕骨	wàngǔ	wrist bone	Incorrect
腕管	wànguǎn	carpal tunnel	Learnt
危害	wēihài	harm	
微创医学	wēichuāng yīxué	minimally invasive medicine	Incorrect
围产期	wéichǎnqī	perinatal period	
围术期	wéishùqī	perioperative period	Learnt
维持	wéichí	maintain	
维生素	wéishēngsù	vitamins	Incorrect
尾骨	wěigǔ	coccyx	
萎缩	wēisuō	atrophy	
位于	wèiyú	lie in	Learnt
位置	wèizhi	Location	Learnt
胃肠减压	wèicháng jiǎnyā	Gastrointestinal decompression	Learnt
胃蛋白酶	wèidànbáiméi	pepsin	Incorrect
胃镜	wèijìng	gastroscopy	Incorrect
胃口	wèikǒu	appetite	Learnt
胃泌素瘤	wèimìsù liú	Gastrinoma	
胃排空	wèi páikōng	gastric emptying	Learnt
胃瘫	wèitān	stomach paralysis	Incorrect
喂养	wèiyǎng	feed	Learnt
纹状体	wénzhuàngtǐ	striatum	Learnt
闻	wén	smell	Incorrect
蚊虫叮咬	wénchóng dīngyǎo	mosquito bites	Learnt
吻合口	wěnhé kǒu	Anastomotic stoma	Incorrect
紊乱	wěnluàn	disorder	Learnt
稳定	wěndìng	Stablize	Incorrect
稳态	wěntài	steady state	Incorrect
卧床	wòchuáng	bedridden	Incorrect
无菌术	wújūn shù	Aseptic	
物品	wùpǐn	thing	Learnt
物质	wùzhì	substance	Incorrect
误差	wùchā	error	Incorrect
物化	wùhuà	materialize	Incorrect
吸收	xīshōu	absorb	Learnt
吸氧	xīyǎng	oxygen inhalation	Learnt
息肉	xīròu	polyp	Learnt
膝盖	xīgài	knee	Learnt
膝关节	xīguānjié	knee joint	Incorrect
系统	xìtǒng	system	Incorrect
细胞	xìbāo	cell	Incorrect
细胞株	xìbāozhū	cell line	Learnt
细菌	xìjūn	bacteria	Learnt
狭窄	xiázhǎi	narrow	Learnt
下颌骨	xiàhégǔ	mandible	Incorrect
下降	xiàjiàng	decline	
下腔静脉	xiàqiāng jìngmài	inferior vena cava	
下肢	xiàzhī	lower body	
先天性	xiāntiānxìng	Congenital	Learnt
先兆流产	xiānzhào liúchǎn	Threatened miscarriage	Incorrect
纤溶酶原	xiānróng méiyuán	Plasminogen	Learnt
纤维	xiānwéi	fiber	Incorrect
显示	xiǎnshì	show	
显微外科	xiǎnwēiwàikē	Microsurgery	Learnt
现病史	xiàn bìngshǐ	history of present illness	Learnt
现象	xiànxiàng	Phenomenon	
限期手术	xiànqī shǒushù	Deadline surgery	Incorrect
腺垂体	xiànchuítǐ	pituitary gland	Learnt
相关	xiāngguān	relevant	Learnt
项	xiàng	item	Learnt
消毒	xiāodú	disinfect	Learnt
消化	xiāohuà	Digestion	Learnt
消化道	xiāohuàdào	digestive tract	Learnt
消化腺	xiāohuàxiàn	digestive gland	Learnt
消极	xiāojí	negative	Learnt
消失	xiāoshī	disappear	Incorrect
消瘦	xiāoshòu	thin	
消炎	xiāoyán	anti-inflammatory	Learnt
硝酸甘油	xiāosuāngānyóu	Nitroglycerin	Learnt
小便	xiǎobiàn	pee	Incorrect
哮鸣音	xiàomíngyīn	Wheeze	Learnt
哮喘	xiàochuǎn	asthma	
效价	xiàojià	potency	Learnt
协同作用	xiétóng zuòyòng	Synergy	
斜视	xiéshì	strabismus	
心包	xīnbāo	Pericardium	
心搏骤停	xīnbó zhòutíng	cardiac arrest	
心电图	xīndiàntú	electrocardiogram	
心动过缓	xīndòng guòhuǎn	Bradycardia	Incorrect
心房颤动	xīnfángchàndòng	atrial fibrillation	Incorrect
心肺复苏	xīnfèi fùsū	CPR	Incorrect
心肌梗死	xīnjīgěngsǐ	myocardial infarction	Incorrect
心悸	xīnjì	heart palpitations	Learnt
心尖搏动	xīnjiān bódòng	apical beat	
心绞痛	xīnjiǎotòng	Angina	
心里	xīnli	heart	Learnt
心力衰竭	xīnlìshuāijié	heart failure	
心率	xīnlǜ	heart rate	
心律	xīnlǜ	heart rate	Incorrect
心内膜炎	xīnnèimóyán	Endocarditis	Incorrect
心室	xīnshì	ventricle	Learnt
心态	xīntài	state of mind	Learnt
心音	xīnyīn	heart sound	
心脏	xīnzàng	heart	
心脏压塞	xīnzàng yāsāi	Cardiac tamponade	Learnt
辛辣	xīnlà	spicy	Incorrect
新陈代谢	xīnchéndàixiè	metabolism	Learnt
新生儿	xīnshēngér	newborn	Learnt
猩红热	xīnghóngrè	scarlet fever	
形成	xíngchéng	form	
形态	xíngtài	form	Learnt
行为	xíngwéi	Behavior	Learnt
性病	xìngbìng	venereal disease	Learnt
性交	xìngjiāo	sexual intercourse	
性早熟	xìngzǎoshú	precocious puberty	Learnt
性质	xìngzhì	nature	Learnt
胸部	xiōngbù	Chest	Learnt
胸大肌	xiōngdàjī	pectoralis major	Incorrect
胸导管	xiōng dǎoguǎn	Thoracic duct	
胸骨	xiōnggǔ	sternum	
胸骨角	xiōnggǔ jiǎo	Sternal angle	
胸口	xiōngkǒu	the chest	
胸闷	xiōngmēn	Chest tightness	
胸膜	xiōngmó	pleura	
胸腔	xiōngqiāng	chest cavity	
胸透	xiōngtòu	Chest x-ray	Incorrect
胸围	xiōngwéi	chest circumference	Learnt
胸腺瘤	xiōng xiànliú	Thymoma	Incorrect
雄激素	xióngjīsù	androgen	Learnt
休克	xiūkè	shock	
修补术	xiūbǔshù	Prosthetics	Learnt
修复	xiūfù	repair	
嗅觉	xiùjué	the sense of smell	
嗅神经	xiùshénjīng	olfactory nerve	
酗酒	xùjiǔ	alcoholism	Incorrect
癣	xuǎn	ringworm	
眩晕	xuànyùn	dizziness	Learnt
血氨	xuè ān	blood ammonia	Incorrect
血红蛋白	xuèhóngdànbái	hemoglobin	Learnt
血肌酐	xuè jīgān	serum creatinine	
血库	xuèkù	blood bank	Learnt
血脑屏障	xuènǎopíngzhàng	blood brain barrier	
血尿素氮	xuè niàosùdàn	blood urea nitrogen	
血培养	xuè péiyǎng	blood culture	Incorrect
血气分析	xuèqì fēnxī	blood gas analysis	Learnt
血清铁	xuèqīng tiě	serum iron	Incorrect
血糖	xuètáng	blood sugar	Incorrect
血吸虫病	xuèxīchóngbìng	Schistosomiasis	Incorrect
血象	xuèxiàng	Blood	Incorrect
血小板	xuèxiǎobǎn	platelets	
血行播散	xuèxíng bōsàn	Hematogenous spread	
血型	xuèxíng	blood type	
血胸	xuèxiōng	hemothorax	Incorrect
血压	xuèyā	blood pressure	Learnt
血友病	xuèyǒubìng	hemophilia	Incorrect
血脂	xuèzhī	blood fat	Learnt
询问	xúnwèn	ask	Learnt
荨麻疹	xúnmázhěn	hives	
循环	xúnhuán	cycle	Incorrect
训练	xùnliàn	train	
迅速	xùnsù	fast	
压疮	yāchuāng	pressure sore	
压迫	yāpò	oppression	Incorrect
压痛	yātòng	tenderness	Learnt
牙槽骨	yácáogǔ	alveolar bone	Learnt
牙齿	yáchǐ	teeth	Learnt
牙冠	yáguān	dental crown	Incorrect
牙体	yátǐ	tooth body	Incorrect
牙龈	yáyín	gums	Incorrect
牙周组织	yázhōuzǔzhī	periodontium	Learnt
亚急性	yàjíxìng	Subacute	Learnt
压降康	yājiàngkāng	Vacuum Kang	
眼部	yǎnbù	eyes	Learnt
咽鼓管	yāngǔguǎn	Eustachian tube	Learnt
淹溺	yānnì	to drown	
延期	yánqī	postpone	
延髓	yánsuǐ	medulla oblongata	
炎热	yánrè	hot	Learnt
眼睑	yǎnjiǎn	eyelids	Learnt
眼球	yǎnqiú	eyeball	Incorrect
羊膜	yángmó	Amniotic membrane	Learnt
羊水	yángshuǐ	amniotic fluid	
阳性	yángxìng	Positive	
仰卧位	yǎngwòwèi	supine position	Learnt
氧气	yǎngqì	oxygen	Learnt
痒	yǎng	itch	Learnt
腰	yāo	waist	Incorrect
腰椎	yāozhuī	lumbar spine	
药物	yàowù	drug	Incorrect
叶酸	yèsuān	folic acid	Incorrect
液体	yètǐ	liquid	Learnt
腋神经	yè shénjīng	axillary nerve	
衣原体	yīyuántǐ	Chlamydia	Learnt
遗嘱	yízhǔ	will	Incorrect
依赖性	yīlàixìng	depend on	Learnt
胰岛素	yídǎosù	insulin	Learnt
胰腺	yíxiàn	pancreas	
移动	yídòng	move	Learnt
移行	yíxíng	migrate	
移位	yíwèi	shift	Incorrect
移植	yízhí	transplant	Incorrect
遗传	yíchuán	heredity	
遗尿	yíniào	enuresis	
乙肝	yǐgān	Hepatitis B	
乙型脑炎	yǐxíng nǎoyán	Japanese encephalitis	
以及	yǐjí	as well as	
以免	yǐmiǎn	so as not to	
异常	yìcháng	abnormal	Learnt
异位妊娠	yìwèi rènshēn	ectopic pregnancy	Learnt
异物	yìwù	foreign body	Learnt
抑郁	yìyù	depression	
疫苗	yìmiáo	vaccine	Learnt
意识	yìshí	consciousness	
意外	yìwài	Accident	Learnt
因素	yīnsù	factor	Incorrect
阴道	yīndào	vaginal	Incorrect
阴茎	yīnjīng	penis	
阴性	yīnxìng	Negative	Learnt
银屑病	yínxièbìng	psoriasis	
引产术	yǐnchǎn shù	Induction of labor	
引发	yǐnfā	cause	Learnt
引流	yǐnliú	drainage	
饮食	yǐnshí	diet	
隐患	yǐnhuàn	Hidden danger	Incorrect
隐痛	yǐntòng	dull pain	Incorrect
隐性感染	yǐnxìng gǎnrǎn	latent infection	Incorrect
婴儿	yīngér	baby	Learnt
营养	yíngyǎng	Nutrition	Learnt
应激	yìngjī	stress	Learnt
应用	yìngyòng	application	
硬膜外腔	yìngmówài qiāng	Epidural space	Incorrect
痈	yōng	carbuncle	Incorrect
用途	yòngtú	use	Learnt
优生优育	yōushēngyōuyù	Eugenics	Learnt
犹豫	yóuyù	hesitate	Learnt
油腻	yóunì	greasy	Incorrect
疣	yóu	wart	Learnt
幼儿期	yòurqī	early childhood	Incorrect
诱因	yòuyīn	cause	Incorrect
瘀斑	yūbān	ecchymosis	
瘀点	yū diǎn	Petechiae	
预防	yùfáng	prevention	Incorrect
预期	yùqī	expected	
预先	yùxiān	advance	Learnt
原代细胞	yuándài xìbāo	Primary cells	Learnt
原发病灶	yuánfā bìngzào	primary lesion	Learnt
原发性	yuánfāxìng	primary	Incorrect
原则	yuánzé	in principle	Incorrect
远视	yuǎnshì	hyperopia	
月经初潮	yuèjīng chūcháo	Menarche	
月经史	yuèjīng shǐ	menstrual history	Incorrect
晕厥	yūnjué	syncope	Incorrect
孕激素	yùnjīsù	progesterone	Learnt
杂音	záyīn	murmur	Learnt
再灌注	zài guànzhù	reperfusion	Incorrect
再燃	zàirán	Reburn	Learnt
再植	zàizhí	Replant	Learnt
暂停	zàntíng	pause	Incorrect
早产	zǎochǎn	premature birth	Learnt
早期	zǎoqī	early	Incorrect
早孕	zǎoyùn	early pregnancy	
造成	zàochéng	cause	Incorrect
造影	zàoyǐng	contrast	Incorrect
择期手术	zéqī shǒushù	elective surgery	Incorrect
增殖期	zēngzhí qī	proliferation phase	Learnt
粘连	zhānlián	Adhesion	Learnt
占位效应	zhànwèi xiàoyìng	mass effect	Incorrect
掌握	zhǎngwò	master	Learnt
障碍	zhàngài	obstacle	Learnt
照射	zhàoshè	to irradiate	Incorrect
折磨	zhémó	torment	Learnt
着凉	zháoliáng	catch a cold	
真菌	zhēnjūn	fungus	
诊断	zhěnduàn	diagnosis	
诊室	zhěnshì	consulting room	Learnt
枕叶	zhěnyè	occipital lobe	
震颤	zhènchàn	Tremor	Learnt
镇定	zhèndìng	calm down	
镇静药	zhènjìngyào	sedatives	Incorrect
镇痛药	zhèntòngyào	analgesics	Learnt
征求	zhēngqiú	seek	Learnt
正常菌群	zhèngcháng jūnqún	normal flora	Incorrect
正畸学	zhèngjī xué	Orthodontics	Incorrect
证件	zhèngjiàn	documents	Incorrect
症状	zhèngzhuàng	symptom	Incorrect
支气管	zhīqìguǎn	Bronchus	Learnt
支原体	zhīyuántǐ	Mycoplasma	Incorrect
知觉	zhījué	perception	Learnt
脂蛋白	zhīdànbái	lipoprotein	
脂肪	zhīfáng	Fat	Learnt
蜘蛛痣	zhīzhūzhì	Spider naevi	Incorrect
直肠	zhícháng	rectum	Incorrect
直径	zhíjìng	diameter	Learnt
植皮术	zhípí shù	skin grafting	
止痛	zhǐtòng	pain relief	
止血	zhǐxuè	stop bleeding	Learnt
指标	zhǐbiāo	index	Incorrect
指导	zhǐdǎo	guide	Learnt
指骨	zhǐgǔ	phalanx	
指甲	zhǐjia	nail	Learnt
指检	zhǐjiǎn	Finger check	
指数	zhǐshù	index	Incorrect
指征	zhǐzhēng	indication	Learnt
治疗	zhìliáo	treat	Learnt
痔	zhì	hemorrhoid	
窒息	zhìxī	asphyxia	Learnt
中耳	zhōngěr	middle ear	
中脑	zhōngnǎo	midbrain	Incorrect
中毒	zhòngdú	poisoned	Learnt
中暑	zhòngshǔ	heat stroke	Incorrect
终身	zhōngshēn	lifelong	Learnt
终止	zhōngzhǐ	termination	
肿块	zhǒngkuài	lump	Learnt
肿瘤	zhǒngliú	the tumor	Learnt
肿胀	zhǒngzhàng	swelling	Incorrect
舟状腹	zhōuzhuàngfù	Scaphoid	Learnt
周期	zhōuqī	cycle	Learnt
轴突	zhóutū	axon	Incorrect
肘关节	zhǒuguānjié	Elbow	Learnt
皱纹	zhòuwén	wrinkle	Learnt
侏儒症	zhūrúzhèng	Dwarfism	Learnt
主动脉瓣	zhǔdòngmàibàn	aortic valve	Learnt
主诉	zhǔsù	chief complaint	
注射	zhùshè	injection	
专家	zhuānjiā	expert	Learnt
转移	zhuǎnyí	transfer	Learnt
状况	zhuàngkuàng	situation	Learnt
状态	zhuàngtài	state	Learnt
椎骨	zhuīgǔ	vertebra	
椎管	zhuīguǎn	spinal canal	Incorrect
锥体	zhuītǐ	cone	
浊音	zhuóyīn	voiced sound	
着床	zhuóchuáng	implantation	Incorrect
子宫复旧	zǐgōng fùjiù	Uterine involution	Learnt
子宫肌瘤	zǐgōng jīliú	Uterine fibroids	
子痫前期	zixián qiánqī	Preeclampsia	
紫癜	zǐdiàn	Purpura	Learnt
自发性	zìfāxìng	spontaneity	
自理	zìlǐ	Take care of yourself	Incorrect
自由	zìyóu	free	
自愈	zìyù	self-healing	Learnt
自主	zìzhǔ	independent	Learnt
综合征	zōnghézhēng	syndrome	Learnt
总蛋白	zǒng dànbái	Total protein	Incorrect
纵隔	zònggé	Mediastinum	Incorrect
足部	zúbù	foot	Learnt
足弓	zúgōng	arch of foot	
足月儿	zúyuèr	Full-term baby	Learnt
组成	zǔchéng	composition	Learnt
遵循	zūnxún	follow	Incorrect
作息	zuòxī	work and rest	Learnt
坐高	zuògāo	Sitting height	Learnt